NO assets/eagle.xpm
SO assets/bluestone.xpm
WE assets/wood.xpm
EA assets/greystone.xpm

F 66,66,66
C 206,235,255

11111111111
11110001111
11110001111
11110001111
10000000001
10000000001
10000000001
10000000001111111 
10000000001111111
10000000001111111
10000000001
10000000001
10000000001
10000000001111111111111111111111111111
10000000000000000000000000000000000001
10000000000000000000000000000000000001
10000000000000000000000000000000000001
10000000000000000000000000000000000001
10000000000000000000000000000000000001
10000000000000000000000000000000000001
10000000000000000000000000000000000001
10000000000000000N00000000000000000001
10000000000000000000000000000000000001
10000000000000000000000000000000000001
10000000000000000000000000000000000001
10000000000000000000000000000000000001
10000000000000000000000000000000000001
10000000001111111111111111111111111111
10000000001
10000000001
10000000001
10000000001
10000000001
10000000001
10000000001
10000000001
11110001111
11110001111
11110001111
11111111111
