NO assets/bluestone.xpm
SO assets/redbrick.xpm
WE assets/eagle.xpm
EA assets/mossy.xpm

F 220,100,0
C 225,30,0

1111111111111111111111111
1000000000110000000000001
1011000001110000000000001
1001000000000000000000001
1111111110110000011100001
100000000011000001110111111111111
11110111111111011100000010001
11110111111111011101010010001
11000000110101011100000010001
10000000000000001100000010001
10000000000000001101010010001
110000011101011111111110N0111
111101111110101101111010001
1111111111111111111111111
