NO assets/eagle.xpm


SO    assets/bluestone.xpm
    EA    asstes/greystone.xpm
F 11,169,,,,     20
WE       assets/wood.xpm

C 153  ,  204,,255

11111111111111111111111111111111111
10000011111111100000111111111000001
10000011111111100000111111111000001
1000001111111100000111111111000001
10000011111111100000111111111000001
10N0000000000000000000000000000001
11111111111111111111111111111111111

11111111111111111
