       1111111111111111111111111111111
       1000000000000100000000000000001
11111111000000000N000001000000000011111111
1000000000000000000000000000000000000000001
1000000000000000000000000000000000000000001       
1000000000000000000000000000000000000000001  
1111111111111111111111111111111111111111111
